Symbol	Description
A6Y0	
ADY0	
AEDAUD	UAE Dirham / Australian Dollar
AEDBHD	
AEDCAD	AED / CAD
AEDCHF	UAE Dirham / Swiss Franc
AEDDKK	AED / DKK
AEDEUR	AED / EUR
AEDGBP	UAE Dirham / British Pound
AEDINR	AED / INR
AEDJPY	UAE Dirham / Japanese Yen
AEDNOK	AED / NOK
AEDNZD	AED / NZD
AEDPKR	UAE Dirham / Pakistani Rupee
AEDSAR	AED / SAR
AEDSEK	AED / SEK
AEDUSD	UAE Dirham / US Dollar
AEDZAR	AED / ZAR
AFNGBP	
ALLEUR	
ALLGBP	ALL / GBP
ALLUSD	
AMDGBP	
ARSAUD	ARS / AUD
ARSBRL	ARS / BRL
ARSCAD	ARS / CAD
ARSCHF	ARS / CHF
ARSCLP	
ARSCOP	
ARSEUR	ARS / EUR
ARSGBP	ARS / GBP
ARSHKD	ARS / HKD
ARSJPY	ARS / JPY
ARSMXN	ARS / MXN
ARSPEN	
ARSSGD	ARS / SGD
ARSUSD	Argentinian Peso / US Dollar
ARSZAR	ARS / ZAR
AUDAED	AUD / AED
AUDARS	AUD / ARS
AUDBGN	
AUDBRL	AUD / BRL
AUDCAD	AUD / CAD
AUDCAD.O	
AUDCAD.S	
AUDCHF	AUD / CHF
AUDCHF.A	
AUDCLP	
AUDCNH	AUD / CNH
AUDCNY	AUD / CNY
AUDCZK	AUD / CZK
AUDDKK	AUD / DKK
AUDEUR	AUD / EUR
AUDFJD	AUD / FJD
AUDGBP	AUD / GBP
AUDHKD	AUD / HKD
AUDHUF	AUD / HUF
AUDIDR	AUD / IDR
AUDILS	AUD / ILS
AUDINR	AUD / INR
AUDJPY	AUD / JPY
AUDKRW	AUD / KRW
AUDMAD	
AUDMXN	AUD / MXN
AUDMYR	AUD / MYR
AUDNOK	AUD / NOK
AUDNZD	AUD / NZD
AUDNZD.A	
AUDPGK	
AUDPHP	AUD / PHP
AUDPKR	Australian Dollar / Pakistani Rupee
AUDPLN	AUD / PLN
AUDSEK	AUD / SEK
AUDSGD	AUD / SGD
AUDTHB	AUD / THB
AUDTRY	AUD / TRY
AUDTWD	AUD / TWD
AUDUSD	AUD / USD
AUDUSD.1	
AUDUSD.2	
AUDUSD.3	
AUDUSD.6	
AUDUSD.A	
AUDUSD.B	
AUDUSD.C	
AUDUSD.D	
AUDUSD.E	
AUDUSD.G	
AUDUSD.H	
AUDUSD.J	
AUDUSD.K	
AUDUSD.M	
AUDUSD.N	
AUDUSD.O	
AUDUSD.Q	
AUDUSD.S	
AUDUSD.U	
AUDUSD.V	
AUDUSD.X	
AUDZAR	AUD / ZAR
AWGGBP	
AWGUSD	AWG / USD
B6Y0	
BAMGBP	
BAMUSD	
BBDEUR	
BBDGBP	
BBDUSD	
BDTGBP	BDT / GBP
BDTJPY	BDT / JPY
BDTUSD	
BGNAUD	
BGNCAD	
BGNCNY	BGN / CNY
BGNDKK	BGN / DKK
BGNUSD	BGN / USD
BHDEUR	BHD / EUR
BHDPKR	Baharain Dinar / Pakistani Rupee
BHDUSD	BHD / USD
BIFUSD	
BMDBBD	
BMDCAD	
BMDEUR	
BMDGBP	
BMDKYD	
BNDGBP	BND / GBP
BNDUSD	
BOBGBP	
BOBUSD	
BPY0	
BRLARS	BRL / ARS
BRLAUD	BRL / AUD
BRLCAD	BRL / CAD
BRLCHF	BRL / CHF
BRLCLP	BRL / CLP
BRLCNY	
BRLCOP	
BRLDKK	BRL / DKK
BRLEUR	BRL / EUR
BRLHKD	BRL / HKD
BRLJPY	BRL / JPY
BRLKRW	BRL / KRW
BRLMXN	BRL / MXN
BRLPEN	
BRLRSD	
BRLRUB	BRL / RUB
BRLSEK	BRL / SEK
BRLSGD	BRL / SGD
BRLUSD	BRL / USD
BRLZAR	BRL / ZAR
BSDGBP	
BSDUSD	
BTNGBP	
BTNUSD	
BWPCHF	BWP / CHF
BWPEUR	BWP / EUR
BWPGBP	BWP / GBP
BWPUSD	BWP / USD
BWPZAR	BWP / ZAR
BZDUSD	
CADAED	CAD / AED
CADARS	CAD / ARS
CADAUD	CAD / AUD
CADBGN	
CADBMD	
CADBRL	CAD / BRL
CADCHF	CAD / CHF
CADCHF.A	
CADCHF.C	
CADCHF.S	
CADCNH	CAD / CNH
CADCNY	CAD / CNY
CADCOP	Canadian Dollar / Colombian Peso
CADCZK	
CADDKK	CAD / DKK
CADEUR	CAD / EUR
CADGBP	CAD / GBP
CADHKD	CAD / HKD
CADHUF	
CADIDR	CAD / IDR
CADILS	CAD / ILS
CADINR	CAD / INR
CADJPY	CAD / JPY
CADJPY.A	
CADKRW	CAD / KRW
CADKWD	CAD / KWD
CADKYD	
CADMXN	CAD / MXN
CADMYR	CAD / MYR
CADNOK	CAD / NOK
CADNZD	CAD / NZD
CADPEN	
CADPKR	Canadian Dollar / Pakistani Rupee
CADPLN	CAD / PLN
CADRUB	CAD / RUB
CADSAR	
CADSEK	CAD / SEK
CADSGD	CAD / SGD
CADTHB	CAD / THB
CADTRY	CAD / TRY
CADTWD	CAD / TWD
CADUSD	CAD / USD
CADVND	
CADZAR	CAD / ZAR
CDFGBP	
CDFUSD	CDF / USD
CDY0	
CHFAED	Swiss Franc / UAE Dirham
CHFARS	CHF / ARS
CHFAUD	CHF / AUD
CHFBRL	CHF / BRL
CHFBWP	CHF / BWP
CHFCAD	CHF / CAD
CHFCLP	
CHFCNH	CHF / CNH
CHFCNY	CHF / CNY
CHFCZK	CHF / CZK
CHFDKK	CHF / DKK
CHFEUR	CHF / EUR
CHFGBP	CHF / GBP
CHFHKD	CHF / HKD
CHFHUF	CHF / HUF
CHFIDR	CHF / IDR
CHFILS	CHF / ILS
CHFINR	CHF / INR
CHFJPY	CHF / JPY
CHFJPY.1	
CHFJPY.2	
CHFJPY.A	
CHFJPY.B	
CHFJPY.C	
CHFJPY.D	
CHFJPY.E	
CHFJPY.G	
CHFJPY.H	
CHFJPY.J	
CHFJPY.K	
CHFJPY.M	
CHFJPY.N	
CHFJPY.O	
CHFJPY.Q	
CHFJPY.S	
CHFJPY.U	
CHFJPY.V	
CHFJPY.X	
CHFKRW	CHF / KRW
CHFMXN	CHF / MXN
CHFMYR	CHF / MYR
CHFNOK	CHF / NOK
CHFNZD	CHF / NZD
CHFPKR	CHF / PKR
CHFPLN	CHF / PLN
CHFRON	CHF / RON
CHFRSD	
CHFRUB	CHF / RUB
CHFSEK	CHF / SEK
CHFSGD	CHF / SGD
CHFSZL	CHF / SZL
CHFTHB	CHF / THB
CHFTRY	CHF / TRY
CHFTWD	CHF / TWD
CHFUSD	CHF / USD
CHFZAR	CHF / ZAR
CLPARS	
CLPAUD	
CLPBRL	Chilean Peso / Brazil Real
CLPCHF	
CLPCNY	
CLPCOP	
CLPEUR	CLP / EUR
CLPGBP	CLP / GBP
CLPMXN	
CLPPEN	
CLPUSD	Chilean Peso / US Dollar
CNHHKD	CNH / HKD
CNHIDR	CNH / IDR
CNHINR	CNH / INR
CNHJPY	CNH / JPY
CNHKRW	CNH / KRW
CNHPHP	CNH / PHP
CNHTHB	CNH / THB
CNHTWD	CNH / TWD
CNYAUD	CNY / AUD
CNYBGN	CNY / BGN
CNYBRL	
CNYCAD	CNY / CAD
CNYCHF	CNY / CHF
CNYCLP	Chinese Yuan / Chilean Peso
CNYDKK	CNY / DKK
CNYEUR	CNY / EUR
CNYGBP	CNY / GBP
CNYHKD	CNY / HKD
CNYINR	
CNYJPY	CNY / JPY
CNYKRW	CNY / KRW
CNYMYR	CNY / MYR
CNYNZD	CNY / NZD
CNYRUB	
CNYSGD	
CNYTWD	
CNYUSD	Chinese Yuan / US Dollar
CNYZAR	CNY / ZAR
COPARS	
COPBRL	
COPCAD	
COPCLP	
COPDKK	COP / DKK
COPMXN	
COPUSD	Colombian Peso / US Dollar
COPZAR	
CRCEUR	
CRCGBP	CRC / GBP
CRCUSD	
CUPUSD	
CVEGBP	
CVEUSD	
CZKCAD	
CZKCHF	CZK / CHF
CZKDKK	CZK / DKK
CZKEUR	CZK / EUR
CZKJPY	CZK / JPY
CZKMXN	CZK / MXN
CZKNOK	CZK / NOK
CZKPLN	CZK / PLN
CZKSEK	CZK / SEK
CZKUSD	CZK / USD
CZKZAR	
D6Y0	
DJFGBP	DJF / GBP
DJFUSD	
DKKAED	DKK / AED
DKKAUD	DKK / AUD
DKKBGN	DKK / BGN
DKKBRL	DKK / BRL
DKKCAD	DKK / CAD
DKKCHF	DKK / CHF
DKKCNY	DKK / CNY
DKKCOP	DKK / COP
DKKCZK	DKK / CZK
DKKEUR	DKK / EUR
DKKEUR.1	
DKKEUR.A	
DKKEUR.B	
DKKEUR.C	
DKKEUR.D	
DKKEUR.E	
DKKEUR.G	
DKKEUR.H	
DKKEUR.J	
DKKEUR.K	
DKKEUR.M	
DKKEUR.N	
DKKEUR.Q	
DKKEUR.S	
DKKEUR.U	
DKKEUR.V	
DKKEUR.X	
DKKGBP	DKK / GBP
DKKHKD	DKK / HKD
DKKHUF	DKK / HUF
DKKINR	DKK / INR
DKKISK	DKK / ISK
DKKJPY	DKK / JPY
DKKMXN	DKK / MXN
DKKMYR	DKK / MYR
DKKNOK	DKK / NOK
DKKNZD	DKK / NZD
DKKPHP	DKK / PHP
DKKPKR	DKK / PKR
DKKPLN	DKK / PLN
DKKRUB	
DKKSEK	DKK / SEK
DKKSGD	DKK / SGD
DKKTHB	DKK / THB
DKKTRY	DKK / TRY
DKKTWD	DKK / TWD
DKKUAH	DKK / UAH
DKKUSD	DKK / USD
DKKZAR	DKK / ZAR
DOPGBP	DOP / GBP
DOPUSD	
DZDEUR	DZD / EUR
DZDUSD	DZD / USD
E6Y0	
ECBAUD	
ECBBGN	
ECBBRL	
ECBCAD	
ECBCHF	
ECBCNY	
ECBCZK	
ECBDKK	
ECBGBP	
ECBHKD	
ECBHUF	
ECBIDR	
ECBILS	
ECBINR	
ECBISK	
ECBJPY	
ECBKRW	
ECBMXN	
ECBMYR	
ECBNOK	
ECBNZD	
ECBPHP	
ECBPLN	
ECBRON	
ECBSEK	
ECBSGD	
ECBTHB	
ECBTRY	
ECBUSD	
ECBZAR	
ECY0	
EGPBRL	
EGPEUR	EGP / EUR
EGPJPY	EGP / JPY
EGPPKR	Egyptian Pound / Pakistani Rupee
EGPUSD	EGP / USD
EGPZAR	
ETBGBP	ETB / GBP
ETBUSD	
EURAED	EUR / AED
EURAFN	Euro / Afghanistan Afghani
EURALL	EUR / ALL
EURAMD	EUR / AMD
EURARS	EUR / ARS
EURAUD	EUR / AUD
EURAUD.1	
EURAUD.2	
EURAUD.A	
EURAUD.B	
EURAUD.C	
EURAUD.D	
EURAUD.E	
EURAUD.G	
EURAUD.H	
EURAUD.J	
EURAUD.K	
EURAUD.M	
EURAUD.N	
EURAUD.Q	
EURAUD.S	
EURAUD.U	
EURAUD.V	
EURAUD.X	
EURBAM	EUR / BAM
EURBBD	Euro / Barbadian Dollar
EURBDT	Euro / Bangladeshi Taka
EURBGN	Euro / Bulgarian Lev
EURBHD	EUR / BHD
EURBIF	Euro / Burundian Franc
EURBMD	
EURBND	Euro / Brunei Dollar
EURBOB	Euro / Bolivian Boliviano
EURBRL	EUR / BRL
EURBRP	
EURBSD	Euro / Bahamas Dollar
EURBTN	
EURBWP	EUR / BWP
EURBZD	Euro / Belize Dollar
EURCAD	EUR / CAD
EURCAD.1	
EURCAD.2	
EURCAD.A	
EURCAD.B	
EURCAD.C	
EURCAD.D	
EURCAD.E	
EURCAD.G	
EURCAD.H	
EURCAD.J	
EURCAD.K	
EURCAD.M	
EURCAD.N	
EURCAD.O	
EURCAD.Q	
EURCAD.S	
EURCAD.U	
EURCAD.V	
EURCAD.X	
EURCDF	
EURCHF	EUR / CHF
EURCLP	Euro / Chilean Peso
EURCNH	EUR / CNH
EURCNY	EUR / CNY
EURCOP	Euro / Colombian Peso
EURCRC	Euro / Costa Rican Colon
EURCUP	Euro / Cuban Peso
EURCVE	Euro / Cape Verdean Escudo
EURCZK	EUR / CZK
EURDJF	Euro / Djiboutian Franc
EURDKK	EUR / DKK
EURDKK.A	
EURDKK.S	
EURDOP	Euro / Dominican Peso
EURDZD	EUR / DZD
EUREGP	EUR / EGP
EURETB	EUR / ETB
EURFJD	EUR / FJD
EURGBP	EUR / GBP
EURGBP.1	
EURGBP.2	
EURGBP.A	
EURGBP.B	
EURGBP.C	
EURGBP.D	
EURGBP.E	
EURGBP.G	
EURGBP.H	
EURGBP.J	
EURGBP.K	
EURGBP.M	
EURGBP.N	
EURGBP.O	
EURGBP.Q	
EURGBP.S	
EURGBP.U	
EURGBP.V	
EURGBP.X	
EURGHS	Euro / Ghanaian Cedi
EURGMD	Euro / Gambian Dalasi
EURGNF	Euro / Guinean Franc
EURGTQ	Euro / Guatemalan Quetzal
EURGYD	
EURHKD	EUR / HKD
EURHNL	Euro / Honduran Lempira
EURHTG	Euro / Haitian Gourde
EURHUF	EUR / HUF
EURHUY	
EURIDR	EUR / IDR
EURILS	Euro / Israeli Shekel
EURINR	EUR / INR
EURIQD	Euro / Iraqi Dinar
EURISK	EUR / ISK
EURJMD	Euro / Jamaican Dollar
EURJOD	EUR / JOD
EURJPY	EUR / JPY
EURJPY.A	
EURJPY.O	
EURKES	Euro / Kenyan Shilling
EURKHR	Euro / Cambodian Riel
EURKRW	EUR / KRW
EURKWD	EUR / KWD
EURKYD	Euro / Cayman Islands Dollar
EURKZT	Euro / Kazakh Tenge
EURLAK	Euro / Lao Kip
EURLBP	EUR / LBP
EURLKR	EUR / LKR
EURLRD	
EURLSL	EUR / LSL
EURLYD	Euro / Libyan Dinar
EURMAD	Euro / Moroccan Dirham
EURMDL	Euro / Moldovan Leu
EURMGA	Euro / Malagasy Ariary
EURMKD	EUR / MKD
EURMOP	EUR / MOP
EURMUR	EUR / MUR
EURMVR	EUR / MVR
EURMWK	Euro / Malawian Kwacha
EURMXN	EUR / MXN
EURMYR	Euro / Malaysian Ringgit
EURNAD	Euro / Namibian Dollar
EURNGN	Euro / Nigerian Naira
EURNIO	Euro / Nicaraguan Cordoba
EURNOK	EUR / NOK
EURNOK.1	
EURNOK.2	
EURNOK.A	
EURNOK.B	
EURNOK.C	
EURNOK.D	
EURNOK.E	
EURNOK.G	
EURNOK.H	
EURNOK.J	
EURNOK.K	
EURNOK.M	
EURNOK.N	
EURNOK.Q	
EURNOK.S	
EURNOK.U	
EURNOK.V	
EURNOK.X	
EURNPR	EUR / NPR
EURNZD	EUR / NZD
EURNZD.1	
EURNZD.2	
EURNZD.B	
EURNZD.C	
EURNZD.D	
EURNZD.E	
EURNZD.G	
EURNZD.H	
EURNZD.J	
EURNZD.K	
EURNZD.M	
EURNZD.N	
EURNZD.Q	
EURNZD.S	
EURNZD.U	
EURNZD.V	
EURNZD.X	
EUROMR	EUR / OMR
EURPAB	Euro / Panamanian Balboa
EURPEN	Euro / Peru Sol
EURPGK	EUR / PGK
EURPHP	EUR / PHP
EURPKR	EUR / PKR
EURPLN	EUR / PLN
EURPLN.1	
EURPLN.A	
EURPLN.B	
EURPLN.C	
EURPLN.E	
EURPLN.G	
EURPLN.H	
EURPLN.J	
EURPLN.K	
EURPLN.M	
EURPLN.N	
EURPLN.Q	
EURPLN.S	
EURPLN.U	
EURPLN.V	
EURPLN.X	
EURPYG	Euro / Paraguayan Guarani
EURQAR	Euro / Qatari Riyal
EURRON	Euro / Romanian Leu
EURRON.1	
EURRON.2	
EURRON.A	
EURRON.B	
EURRON.C	
EURRON.D	
EURRON.E	
EURRON.G	
EURRON.H	
EURRON.M	
EURRON.O	
EURRON.U	
EURRSD	EUR / RSD
EURRUB	EUR / RUB
EURRUB.A	
EURRWF	Euro / Rwandan Franc
EURSAR	EUR / SAR
EURSCR	EUR / SCR
EURSDG	Euro / Sudanese Pound
EURSEK	EUR / SEK
EURSEK.2	
EURSEK.A	
EURSEK.B	
EURSEK.C	
EURSEK.D	
EURSEK.E	
EURSEK.G	
EURSEK.H	
EURSEK.M	
EURSEK.S	
EURSGD	EUR / SGD
EURSGD.N	
EURSGD.S	
EURSOS	EUR / SOS
EURSVC	Euro / El Salvador Colon
EURSZL	Euro / Swazi Lilangeni
EURTHB	EUR / THB
EURTJS	Euro / Tajikistani somoni
EURTND	Euro / Tunisian Dinar
EURTRY	EUR / TRY
EURTTD	Euro / Trinidad Dollar
EURTWD	EUR / TWD
EURTZS	Euro / Tanzanian Shilling
EURUAH	Euro / Ukrainian Hryvnia
EURUGX	Euro / Ugandan Shilling
EURUSD	EUR / USD
EURUSD.1	
EURUSD.2	
EURUSD.3	
EURUSD.4	
EURUSD.5	
EURUSD.6	
EURUSD.7	
EURUSD.A	
EURUSD.B	
EURUSD.C	
EURUSD.D	
EURUSD.E	
EURUSD.G	
EURUSD.H	
EURUSD.J	
EURUSD.K	
EURUSD.M	
EURUSD.N	
EURUSD.O	
EURUSD.Q	
EURUSD.S	
EURUSD.U	
EURUSD.V	
EURUSD.X	
EURUSD.Y	
EURUYU	Euro / Uruguayan Peso
EURUZS	EUR / UZS
EURVND	Euro / Vietnamese Dong
EURXAF	Euro / Central African CFA franc
EURXDR	
EURXOF	Euro / West African CFA franc
EURXPF	Euro / French Pacific Franc
EURYER	EUR / YER
EURZAR	EUR / ZAR
EURZMW	
FJDGBP	FJD / GBP
FJDUSD	FJD / USD
GBPAED	British Pound / UAE Dirham
GBPAFN	
GBPALL	GBP / ALL
GBPAMD	
GBPARS	GBP / ARS
GBPAUD	GBP / AUD
GBPAUD.A	
GBPAUD.D	
GBPAUD.S	
GBPAWG	
GBPBAM	
GBPBBD	British Pound / Barbadian Dollar
GBPBDT	British Pound / Bangladeshi Taka
GBPBGN	GBP / BGN
GBPBHD	GBP / BHD
GBPBIF	British Pound / Burundian Franc
GBPBMD	GBP / BMD
GBPBND	GBP / BND
GBPBOB	
GBPBRL	GBP / BRL
GBPBSD	British Pound / Bahamas Dollar
GBPBTN	
GBPBWP	GBP / BWP
GBPBZD	
GBPCAD	GBP / CAD
GBPCDF	
GBPCHF	GBP / CHF
GBPCLP	GBP / CLP
GBPCNH	GBP / CNH
GBPCNY	GBP / CNY
GBPCOP	British Pound / Colombian Peso
GBPCRC	GBP / CRC
GBPCUP	
GBPCVE	
GBPCZK	GBP / CZK
GBPDJF	British Pound / Djiboutian Franc
GBPDKK	GBP / DKK
GBPDOP	GBP / DOP
GBPDZD	GBP / DZD
GBPEGP	GBP / EGP
GBPETB	GBP / ETB
GBPEUR	GBP / EUR
GBPFJD	GBP / FJD
GBPGHS	
GBPGMD	British Pound / Gambian Dalasi
GBPGNF	
GBPGTQ	GBP / GTQ
GBPGYD	
GBPHKD	GBP / HKD
GBPHNL	British Pound / Honduran Lempira
GBPHTG	GBP / HTG
GBPHUF	GBP / HUF
GBPIDR	GBP / IDR
GBPILS	GBP / ILS
GBPINR	GBP / INR
GBPIQD	British Pound / Iraqi Dinar
GBPISK	GBP / ISK
GBPJMD	British Pound / Jamaican Dollar
GBPJOD	British Pound / Jordan Dinar
GBPJPY	GBP / JPY
GBPJPY.A	
GBPKES	GBP / KES
GBPKHR	
GBPKMF	
GBPKRW	GBP / KRW
GBPKWD	GBP / KWD
GBPKYD	
GBPKZT	British Pound / Kazakh Tenge
GBPLAK	
GBPLBP	British Pound / Lebanese Pound
GBPLKR	GBP / LKR
GBPLRD	
GBPLSL	
GBPLYD	
GBPMAD	British Pound / Moroccan Dirham
GBPMDL	
GBPMGA	
GBPMKD	
GBPMOP	
GBPMUR	GBP / MUR
GBPMVR	GBP / MVR
GBPMWK	British Pound / Malawian Kwacha
GBPMXN	GBP / MXN
GBPMYR	GBP / MYR
GBPNGN	GBP / NGN
GBPNIO	GBP / NIO
GBPNOK	GBP / NOK
GBPNOK.1	
GBPNOK.A	
GBPNOK.B	
GBPNOK.E	
GBPNOK.G	
GBPNOK.H	
GBPNOK.J	
GBPNOK.K	
GBPNOK.M	
GBPNOK.N	
GBPNOK.Q	
GBPNOK.U	
GBPNOK.V	
GBPNOK.X	
GBPNPR	
GBPNZD	GBP / NZD
GBPOMR	GBP / OMR
GBPPAB	British Pound / Panamanian Balboa
GBPPEN	GBP / PEN
GBPPGK	GBP / PGK
GBPPHP	GBP / PHP
GBPPKR	British Pound / Pakistani Rupee
GBPPLN	GBP / PLN
GBPPYG	
GBPQAR	British Pound / Qatari Riyal
GBPRON	GBP / RON
GBPRSD	GBP / RSD
GBPRUB	GBP / RUB
GBPRWF	
GBPSAR	GBP / SAR
GBPSCR	GBP / SCR
GBPSEK	GBP / SEK
GBPSEK.A	
GBPSEK.S	
GBPSGD	GBP / SGD
GBPSOS	
GBPSVC	
GBPSZL	British Pound / Swazi Lilangeni
GBPTHB	GBP / THB
GBPTND	GBP / TND
GBPTRY	GBP / TRY
GBPTTD	GBP / TTD
GBPTWD	GBP / TWD
GBPTZS	GBP / TZS
GBPUAH	British Pound / Ukrainian Hryvnia
GBPUGX	GBP / UGX
GBPUSD	GBP / USD
GBPUSD.A	
GBPUSD.B	
GBPUSD.C	
GBPUSD.D	
GBPUSD.E	
GBPUSD.G	
GBPUSD.H	
GBPUSD.J	
GBPUSD.K	
GBPUSD.M	
GBPUSD.N	
GBPUSD.O	
GBPUSD.Q	
GBPUSD.S	
GBPUSD.U	
GBPUSD.V	
GBPUSD.X	
GBPUYU	
GBPVND	GBP / VND
GBPXAF	GBP / XAF
GBPXOF	
GBPXPF	GBP / XPF
GBPYER	
GBPZAR	GBP / ZAR
GBPZMW	
GCY0	
GCY00	
GHSEUR	Ghanaian Cedi / Euro
GHSGBP	
GHSUSD	GHS / USD
GHSZAR	
GMDGBP	GMD / GBP
GMDUSD	
GNFGBP	
GNFUSD	
GTQGBP	GTQ / GBP
GTQUSD	
GYDGBP	
GYDUSD	
H5Y0	
HGY00	
HKDARS	HKD / ARS
HKDAUD	HKD / AUD
HKDBRL	HKD / BRL
HKDCAD	HKD / CAD
HKDCHF	HKD / CHF
HKDCNY	HKD / CNY
HKDDKK	HKD / DKK
HKDEUR	HKD / EUR
HKDGBP	HKD / GBP
HKDIDR	HKD / IDR
HKDINR	HKD / INR
HKDJPY	HKD / JPY
HKDKRW	HKD / KRW
HKDMXN	HKD / MXN
HKDMYR	HKD / MYR
HKDNZD	HKD / NZD
HKDPKR	Hong Kong Dollar / Pakistani Rupee
HKDPLN	HKD / PLN
HKDSEK	HKD / SEK
HKDSGD	HKD / SGD
HKDTHB	HKD / THB
HKDTWD	HKD / TWD
HKDUSD	HKD / USD
HKDZAR	HKD / ZAR
HNLGBP	HNL / GBP
HNLUSD	
HTGGBP	HTG / GBP
HTGUSD	
HUFBRL	
HUFCAD	
HUFCHF	HUF / CHF
HUFDKK	HUF / DKK
HUFEUR	HUF / EUR
HUFPLN	HUF / PLN
HUFUSD	HUF / USD
HUFZAR	
IDRAUD	IDR / AUD
IDRCAD	Indonesian Rupiah / Canadian Dollar
IDRCHF	IDR / CHF
IDRCNY	IDR / CNY
IDREUR	Indonesian Rupiah / Euro
IDRGBP	IDR / GBP
IDRHKD	IDR / HKD
IDRINR	IDR / INR
IDRJPY	IDR / JPY
IDRKRW	IDR / KRW
IDRMYR	IDR / MYR
IDRNZD	IDR / NZD
IDRSGD	IDR / SGD
IDRTHB	IDR / THB
IDRTWD	IDR / TWD
IDRUSD	Indonesian Rupiah / US Dollar
IDRZAR	IDR / ZAR
ILSAED	
ILSAUD	ILS / AUD
ILSCAD	ILS / CAD
ILSCHF	ILS / CHF
ILSEUR	Israeli Shekel / Euro
ILSGBP	
ILSJOD	ILS / JOD
ILSJPY	ILS / JPY
ILSNOK	
ILSPLN	Israeli Shekel / Polish Zloty
ILSSEK	ILS / SEK
ILSUSD	Israeli Shekel / US Dollar
ILSZAR	
INRAUD	INR / AUD
INRCAD	INR / CAD
INRCHF	INR / CHF
INRCNY	INR / CNY
INREUR	INR / EUR
INRGBP	INR / GBP
INRHKD	INR / HKD
INRJPY	INR / JPY
INRKRW	INR / KRW
INRMYR	INR / MYR
INRNZD	INR / NZD
INRPKR	Indian Rupee / Pakistani Rupee
INRSEK	INR / SEK
INRSGD	
INRTHB	INR / THB
INRTWD	INR / TWD
INRUSD	INR / USD
INRZAR	INR / ZAR
IQDGBP	IQD / GBP
IQDUSD	
ISKCHF	ISK / CHF
ISKDKK	ISK / DKK
ISKGBP	ISK / GBP
ISKUSD	
J6Y0	
JMDEUR	
JMDGBP	JMD / GBP
JMDUSD	
JODAED	JOD / AED
JODEUR	JOD / EUR
JODILS	JOD / ILS
JODUSD	Jordan Dinar / US Dollar
JPYAED	JPY / AED
JPYARS	JPY / ARS
JPYAUD	JPY / AUD
JPYBRL	JPY / BRL
JPYCAD	JPY / CAD
JPYCHF	JPY / CHF
JPYCLP	Japanese Yen / Chilean Peso
JPYCNY	JPY / CNY
JPYCZK	JPY / CZK
JPYDKK	JPY / DKK
JPYEUR	JPY / EUR
JPYEUR.1	
JPYEUR.2	
JPYEUR.A	
JPYEUR.B	
JPYEUR.C	
JPYEUR.D	
JPYEUR.E	
JPYEUR.G	
JPYEUR.H	
JPYEUR.J	
JPYEUR.K	
JPYEUR.M	
JPYEUR.N	
JPYEUR.O	
JPYEUR.Q	
JPYEUR.S	
JPYEUR.U	
JPYEUR.V	
JPYEUR.X	
JPYGBP	JPY / GBP
JPYHKD	JPY / HKD
JPYIDR	JPY / IDR
JPYILS	JPY / ILS
JPYINR	JPY / INR
JPYKRW	JPY / KRW
JPYMXN	JPY / MXN
JPYMYR	JPY / MYR
JPYNOK	JPY / NOK
JPYNZD	JPY / NZD
JPYNZD.1	
JPYNZD.2	
JPYNZD.A	
JPYNZD.B	
JPYNZD.C	
JPYNZD.D	
JPYNZD.E	
JPYNZD.G	
JPYNZD.H	
JPYNZD.J	
JPYNZD.K	
JPYNZD.M	
JPYNZD.N	
JPYNZD.O	
JPYNZD.Q	
JPYNZD.S	
JPYNZD.U	
JPYNZD.V	
JPYNZD.X	
JPYPKR	Japanese Yen / Pakistani Rupee
JPYPLN	JPY / PLN
JPYRSD	
JPYRUB	JPY / RUB
JPYSAR	
JPYSEK	JPY / SEK
JPYTHB	JPY / THB
JPYTWD	JPY / TWD
JPYUSD	JPY / USD
JPYZAR	JPY / ZAR
JYY0	
KESUSD	KES / USD
KESZAR	KES / ZAR
KHRGBP	
KHRUSD	
KMFGBP	
KMFUSD	KMF / USD
KRWAUD	KRW / AUD
KRWBRL	KRW / BRL
KRWCAD	KRW / CAD
KRWCHF	KRW / CHF
KRWCNY	KRW / CNY
KRWEUR	KRW / EUR
KRWGBP	KRW / GBP
KRWHKD	KRW / HKD
KRWIDR	KRW / IDR
KRWINR	KRW / INR
KRWJPY	KRW / JPY
KRWMYR	KRW / MYR
KRWNZD	KRW / NZD
KRWRUB	KRW / RUB
KRWSEK	KRW / SEK
KRWSGD	KRW / SGD
KRWTHB	KRW / THB
KRWTWD	KRW / TWD
KRWUSD	KRW / USD
KRWZAR	KRW / ZAR
KWDAED	KWD / AED
KWDEUR	
KWDGBP	KWD / GBP
KWDPKR	Kuwaiti Dinar / Pakistani Rupee
KWDUSD	KWD / USD
KYDBMD	
KYDCAD	
KYDEUR	
KYDGBP	
KYDUSD	
KZTGBP	KZT / GBP
KZTUSD	
L6Y0	
LAKGBP	
LAKUSD	
LBPUSD	LBP / USD
LKRGBP	
LKRUSD	LKR / USD
LKRZAR	
LRDGBP	
LRDUSD	LRD / USD
LSLGBP	
LSLUSD	
LYDGBP	
LYDUSD	
M6Y0	
MADAUD	
MADGBP	MAD / GBP
MADUSD	MAD / USD
MADZAR	
MDLEUR	MDL / EUR
MDLGBP	
MDLUSD	MDL / USD
MGAGBP	
MGAUSD	
MKDGBP	
MKDUSD	MKD / USD
MOPUSD	
MUREUR	MUR / EUR
MURGBP	MUR / GBP
MURUSD	MUR / USD
MURZAR	MUR / ZAR
MVRUSD	MVR / USD
MWKGBP	MWK / GBP
MWKUSD	
MWKZAR	
MXNARS	MXN / ARS
MXNAUD	MXN / AUD
MXNBRL	MXN / BRL
MXNCAD	MXN / CAD
MXNCHF	MXN / CHF
MXNCLP	
MXNCOP	
MXNCZK	MXN / CZK
MXNDKK	MXN / DKK
MXNEUR	MXN / EUR
MXNGBP	MXN / GBP
MXNHKD	MXN / HKD
MXNJPY	MXN / JPY
MXNPEN	
MXNPLN	
MXNRUB	
MXNSGD	MXN / SGD
MXNUSD	MXN / USD
MXNZAR	MXN / ZAR
MYRAUD	MYR / AUD
MYRBRL	
MYRCAD	MYR / CAD
MYRCHF	MYR / CHF
MYRCNH	MYR / CNH
MYRCNY	MYR / CNY
MYRDKK	MYR / DKK
MYREUR	MYR / EUR
MYRGBP	MYR / GBP
MYRHKD	MYR / HKD
MYRIDR	MYR / IDR
MYRINR	MYR / INR
MYRJPY	MYR / JPY
MYRKRW	MYR / KRW
MYRNZD	MYR / NZD
MYRPKR	Malaysian Ringgit / Pakistani Rupee
MYRSGD	MYR / SGD
MYRTHB	MYR / THB
MYRTWD	MYR / TWD
MYRUSD	MYR / USD
MYRZAR	MYR / ZAR
MZNUSD	MZN / USD
N6Y0	
NADUSD	
NGNGBP	NGN / GBP
NGNJPY	NGN / JPY
NGNUSD	
NGNZAR	
NIOGBP	NIO / GBP
NIOUSD	
NOKAED	
NOKBRL	
NOKCAD	NOK / CAD
NOKCHF	NOK / CHF
NOKCNH	NOK / CNH
NOKDKK	NOK / DKK
NOKEUR	NOK / EUR
NOKGBP	NOK / GBP
NOKILS	
NOKINR	NOK / INR
NOKJPY	NOK / JPY
NOKPLN	NOK / PLN
NOKRUB	
NOKSEK	NOK / SEK
NOKUSD	NOK / USD
NOKZAR	NOK / ZAR
NPRGBP	
NPRUSD	
NRY0	
NZDAED	NZD / AED
NZDAUD	NZD / AUD
NZDBRL	
NZDCAD	NZD / CAD
NZDCHF	NZD / CHF
NZDCNH	NZD / CNH
NZDCNY	NZD / CNY
NZDCZK	NZD / CZK
NZDDKK	NZD / DKK
NZDEUR	NZD / EUR
NZDGBP	NZD / GBP
NZDHKD	NZD / HKD
NZDHUF	NZD / HUF
NZDIDR	NZD / IDR
NZDINR	NZD / INR
NZDJPY	NZD / JPY
NZDJPY.1	
NZDJPY.2	
NZDJPY.B	
NZDJPY.C	
NZDJPY.D	
NZDJPY.E	
NZDJPY.G	
NZDJPY.H	
NZDJPY.K	
NZDJPY.M	
NZDJPY.Q	
NZDJPY.S	
NZDJPY.U	
NZDJPY.X	
NZDKRW	NZD / KRW
NZDMXN	NZD / MXN
NZDMYR	NZD / MYR
NZDNOK	NZD / NOK
NZDPKR	New Zealand Dollar / Pakistani Rupee
NZDPLN	NZD / PLN
NZDSEK	NZD / SEK
NZDSGD	NZD / SGD
NZDTHB	NZD / THB
NZDTRY	NZD / TRY
NZDTWD	NZD / TWD
NZDUSD	NZD / USD
NZDUSD.1	
NZDUSD.2	
NZDUSD.3	
NZDUSD.4	
NZDUSD.5	
NZDUSD.A	
NZDUSD.B	
NZDUSD.C	
NZDUSD.D	
NZDUSD.E	
NZDUSD.G	
NZDUSD.H	
NZDUSD.J	
NZDUSD.K	
NZDUSD.M	
NZDUSD.N	
NZDUSD.O	
NZDUSD.Q	
NZDUSD.S	
NZDUSD.U	
NZDUSD.V	
NZDUSD.X	
NZDZAR	NZD / ZAR
OMRAED	OMR / AED
OMRGBP	OMR / GBP
OMRPKR	Omani Rial / Pakistani Rupee
OMRUSD	OMR / USD
OMRZAR	OMR / ZAR
PABUSD	
PAY00	
PENARS	
PENBRL	
PENCAD	
PENCLP	
PENCOP	
PENEUR	
PENGBP	PEN / GBP
PENMXN	
PENUSD	Peru Sol / US Dollar
PGKAUD	
PGKGBP	PGK / GBP
PGKUSD	
PHPDKK	PHP / DKK
PHPGBP	PHP / GBP
PHPJPY	PHP / JPY
PHPUSD	PHP / USD
PKREUR	
PKRGBP	PKR / GBP
PKRJPY	Pakistani Rupee / Japanese Yen
PKRUSD	
PKRZAR	PKR / ZAR
PLNBRL	
PLNCHF	PLN / CHF
PLNCZK	PLN / CZK
PLNDKK	PLN / DKK
PLNEUR	PLN / EUR
PLNGBP	PLN / GBP
PLNHUF	PLN / HUF
PLNILS	PLN / ILS
PLNJPY	PLN / JPY
PLNMXN	
PLNNOK	PLN / NOK
PLNSEK	PLN / SEK
PLNUSD	PLN / USD
PLY00	
PYGUSD	Paraguayan Guarani / US Dollar
QARAED	QAR / AED
QARGBP	QAR / GBP
QARPKR	Qatari Riyal / Pakistani Rupee
QARUSD	QAR / USD
QARZAR	QAR / ZAR
R6Y0	
RFY0	
RONCHF	RON / CHF
RONGBP	RON / GBP
RONUSD	RON / USD
RONZAR	
RPY0	
RSDGBP	
RSDUSD	RSD / USD
RUBBRL	
RUBCAD	
RUBCHF	RUB / CHF
RUBDKK	
RUBEUR	
RUBGBP	RUB / GBP
RUBJPY	RUB / JPY
RUBKRW	RUB / KRW
RUBMXN	
RUBNOK	
RUBPLN	RUB / PLN
RUBSEK	
RUBUSD	RUB / USD
RUBZAR	
RWFGBP	
RWFUSD	
RWFZAR	
RYY0	
S6Y0	
SAREUR	SAR / EUR
SARJPY	
SARKWD	
SARPKR	Saudi Riyal / Pakistani Rupee
SARUSD	SAR / USD
SCRGBP	SCR / GBP
SCRUSD	SCR / USD
SEKAUD	SEK / AUD
SEKBRL	
SEKCAD	SEK / CAD
SEKCHF	SEK / CHF
SEKCNH	SEK / CNH
SEKCZK	SEK / CZK
SEKDKK	SEK / DKK
SEKEUR	SEK / EUR
SEKGBP	SEK / GBP
SEKILS	SEK / ILS
SEKINR	SEK / INR
SEKJPY	SEK / JPY
SEKNOK	SEK / NOK
SEKPLN	SEK / PLN
SEKRUB	
SEKUSD	SEK / USD
SEKZAR	SEK / ZAR
SFY0	
SGDAED	SGD / AED
SGDARS	SGD / ARS
SGDAUD	SGD / AUD
SGDBRL	SGD / BRL
SGDCAD	SGD / CAD
SGDCHF	SGD / CHF
SGDCNH	SGD / CNH
SGDCNY	SGD / CNY
SGDDKK	SGD / DKK
SGDEUR	SGD / EUR
SGDEUR.1	
SGDEUR.2	
SGDEUR.A	
SGDEUR.B	
SGDEUR.C	
SGDEUR.D	
SGDEUR.E	
SGDEUR.G	
SGDEUR.H	
SGDEUR.J	
SGDEUR.K	
SGDEUR.M	
SGDEUR.N	
SGDEUR.O	
SGDEUR.Q	
SGDEUR.S	
SGDEUR.U	
SGDEUR.V	
SGDEUR.X	
SGDGBP	SGD / GBP
SGDHKD	SGD / HKD
SGDIDR	SGD / IDR
SGDINR	SGD / INR
SGDJPY	SGD / JPY
SGDJPY.K	
SGDJPY.N	
SGDKRW	SGD / KRW
SGDMXN	SGD / MXN
SGDMYR	SGD / MYR
SGDNOK	
SGDNZD	SGD / NZD
SGDPKR	Singapore Dollar / Pakistani Rupee
SGDPLN	SGD / PLN
SGDSEK	SGD / SEK
SGDTHB	SGD / THB
SGDTRY	
SGDTWD	SGD / TWD
SGDUSD	SGD / USD
SGDZAR	SGD / ZAR
SHPUSD	SHP / USD
SIY0	
SIY00	
SKY0	
SOSGBP	
SOSUSD	
SUSDCN	
SVCGBP	
SVCUSD	
SZLCHF	SZL / CHF
SZLEUR	SZL / EUR
SZLGBP	SZL / GBP
SZLUSD	SZL / USD
SZLZAR	
T6Y0	
THBAUD	THB / AUD
THBCAD	THB / CAD
THBCHF	THB / CHF
THBCNY	THB / CNY
THBEUR	THB / EUR
THBGBP	THB / GBP
THBHKD	THB / HKD
THBIDR	THB / IDR
THBINR	THB / INR
THBJPY	THB / JPY
THBKRW	THB / KRW
THBMYR	THB / MYR
THBNZD	THB / NZD
THBPKR	Thai Baht / Pakistani Rupee
THBSGD	THB / SGD
THBTWD	THB / TWD
THBUSD	THB / USD
THBZAR	THB / ZAR
TJSUSD	
TMTUSD	TMT / USD
TNDGBP	Tunisian Dinar / British Pound
TNDUSD	TND / USD
TNDZAR	
TRYCHF	TRY / CHF
TRYDKK	TRY / DKK
TRYJPY	TRY / JPY
TRYPLN	TRY / PLN
TRYSGD	
TRYUSD	TRY / USD
TRYZAR	TRY / ZAR
TTDGBP	TTD / GBP
TTDUSD	
TWDAUD	TWD / AUD
TWDCAD	TWD / CAD
TWDCHF	TWD / CHF
TWDCNY	TWD / CNY
TWDDKK	TWD / DKK
TWDEUR	
TWDGBP	TWD / GBP
TWDHKD	TWD / HKD
TWDIDR	TWD / IDR
TWDINR	TWD / INR
TWDJPY	TWD / JPY
TWDKRW	TWD / KRW
TWDMYR	TWD / MYR
TWDNZD	TWD / NZD
TWDPKR	Taiwan Dollar / Pakistani Rupee
TWDSEK	TWD / SEK
TWDSGD	TWD / SGD
TWDTHB	TWD / THB
TWDUSD	TWD / USD
TWDZAR	TWD / ZAR
TZSGBP	
TZSUSD	
TZSZAR	TZS / ZAR
UAHDKK	UAH / DKK
UAHEUR	UAH / EUR
UAHUSD	UAH / USD
UCY0	
UEY0	
UGXUSD	
UGXZAR	
UKY0	
USDAED	US Dollar / UAE Dirham
USDAED.3	
USDAED.4	
USDAED.5	
USDAED.A	
USDAED.O	
USDAED.S	
USDAFN	US Dollar / Afghanistan Afghani
USDALL	USD / ALL
USDAMD	USD / AMD
USDARS	USD / ARS
USDARS.1	
USDARS.E	
USDARS.G	
USDARS.H	
USDARS.M	
USDARS.S	
USDARS.U	
USDAUD	USD / AUD
USDAWG	USD / AWG
USDBAM	US Dollar / Bosnian and Herzegovina Convertible Mark
USDBBD	
USDBDT	USD / BDT
USDBGN	USD / BGN
USDBHD	USD / BHD
USDBHD.1	
USDBHD.B	
USDBHD.E	
USDBHD.G	
USDBHD.H	
USDBHD.M	
USDBHD.S	
USDBHD.U	
USDBIF	US Dollar / Burundian Franc
USDBMD	USD / BMD
USDBND	US Dollar / Brunei Dollar
USDBOB	USD / BOB
USDBOC	
USDBRL	USD / BRL
USDBRL.1	
USDBRL.E	
USDBRL.G	
USDBRL.H	
USDBRL.M	
USDBRL.S	
USDBRL.U	
USDBRP	
USDBSD	
USDBWP	USD / BWP
USDBZD	USD / BZD
USDCAD	USD / CAD
USDCDF	USD / CDF
USDCHF	USD / CHF
USDCLP	US Dollar / Chilean Peso
USDCLP.1	
USDCLP.E	
USDCLP.G	
USDCLP.H	
USDCLP.M	
USDCLP.S	
USDCLP.U	
USDCNH	USD / CNH
USDCNY	US Dollar / Chinese Yuan
USDCNY.B	
USDCOP	US Dollar / Colombian Peso
USDCOP.1	
USDCOP.E	
USDCOP.G	
USDCOP.H	
USDCOP.M	
USDCOP.S	
USDCOP.U	
USDCRC	US Dollar / Costa Rican Colon
USDCUP	USD / CUP
USDCVE	USD / CVE
USDCZK	USD / CZK
USDDJF	US Dollar / Djiboutian Franc
USDDKK	USD / DKK
USDDOP	US Dollar / Dominican Peso
USDDZD	USD / DZD
USDEGP	USD / EGP
USDETB	USD / ETB
USDEUR	USD / EUR
USDFJD	USD / FJD
USDGBP	USD / GBP
USDGEL	USD / GEL
USDGHS	US Dollar / Ghanaian Cedi
USDGMD	US Dollar / Gambian Dalasi
USDGNF	USD / GNF
USDGTQ	USD / GTQ
USDGYD	
USDHKD	USD / HKD
USDHKD.A	
USDHKD.B	
USDHKD.C	
USDHKD.O	
USDHKD.S	
USDHNL	US Dollar / Honduran Lempira
USDHTG	USD / HTG
USDHUF	USD / HUF
USDHUF.1	
USDHUF.A	
USDHUF.B	
USDHUF.C	
USDHUF.D	
USDHUF.E	
USDHUF.G	
USDHUF.H	
USDHUF.J	
USDHUF.K	
USDHUF.M	
USDHUF.N	
USDHUF.Q	
USDHUF.S	
USDHUF.U	
USDHUF.V	
USDHUF.X	
USDHUY	
USDIDR	USD / IDR
USDIDR.1	
USDIDR.2	
USDIDR.A	
USDIDR.B	
USDIDR.C	
USDIDR.D	
USDIDR.E	
USDIDR.G	
USDIDR.H	
USDIDR.J	
USDIDR.K	
USDIDR.M	
USDIDR.N	
USDIDR.O	
USDIDR.Q	
USDIDR.S	
USDIDR.U	
USDIDR.V	
USDIDR.X	
USDILS	US Dollar / Israeli Shekel
USDINR	USD / INR
USDINR.1	
USDINR.2	
USDINR.A	
USDINR.B	
USDINR.C	
USDINR.D	
USDINR.E	
USDINR.G	
USDINR.H	
USDINR.J	
USDINR.K	
USDINR.M	
USDINR.N	
USDINR.O	
USDINR.Q	
USDINR.S	
USDINR.U	
USDINR.V	
USDINR.X	
USDIQD	USD / IQD
USDIRR	USD / IRR
USDISK	USD / ISK
USDJMD	US Dollar / Jamaican Dollar
USDJOD	US Dollar / Jordan Dinar
USDJPY	USD / JPY
USDKES	USD / KES
USDKGS	US Dollar / Kyrgyzstan som
USDKHR	USD / KHR
USDKMF	US Dollar / Comorian Franc
USDKRW	USD / KRW
USDKRW.U	
USDKWD	USD / KWD
USDKWD.2	
USDKWD.Y	
USDKYD	
USDKZT	US Dollar / Kazakh Tenge
USDLAK	US Dollar / Lao Kip
USDLBP	US Dollar / Lebanese Pound
USDLKR	USD / LKR
USDLRD	USD / LRD
USDLSL	USD / LSL
USDLYD	USD / LYD
USDMAD	US Dollar / Moroccan Dirham
USDMAD.B	
USDMAD.S	
USDMDL	US Dollar / Moldovan Leu
USDMGA	US Dollar / Malagasy Ariary
USDMKD	USD / MKD
USDMOP	USD / MOP
USDMUR	USD / MUR
USDMVR	US Dollar / Maldivian Rufiyaa
USDMWK	US Dollar / Malawian Kwacha
USDMXN	USD / MXN
USDMXN.1	
USDMXN.2	
USDMXN.3	
USDMXN.4	
USDMXN.5	
USDMXN.A	
USDMXN.B	
USDMXN.C	
USDMXN.D	
USDMXN.E	
USDMXN.G	
USDMXN.H	
USDMXN.J	
USDMXN.K	
USDMXN.M	
USDMXN.N	
USDMXN.O	
USDMXN.Q	
USDMXN.S	
USDMXN.U	
USDMXN.V	
USDMXN.X	
USDMYR	USD / MYR
USDMZN	US Dollar / Mozambican Metical
USDNAD	US Dollar / Namibian Dollar
USDNGN	USD / NGN
USDNIO	US Dollar / Nicaraguan Cordoba
USDNOK	USD / NOK
USDNOK.1	
USDNOK.2	
USDNOK.H	
USDNOK.J	
USDNOK.K	
USDNOK.M	
USDNOK.N	
USDNOK.Q	
USDNOK.U	
USDNOK.V	
USDNOK.X	
USDNPR	USD / NPR
USDNZD	USD / NZD
USDOMR	USD / OMR
USDPAB	USD / PAB
USDPEN	USD / PEN
USDPEN.1	
USDPEN.E	
USDPEN.G	
USDPEN.H	
USDPEN.M	
USDPEN.S	
USDPEN.U	
USDPGK	USD / PGK
USDPHP	USD / PHP
USDPHP.1	
USDPHP.2	
USDPHP.B	
USDPHP.C	
USDPHP.D	
USDPHP.E	
USDPHP.G	
USDPHP.H	
USDPHP.J	
USDPHP.K	
USDPHP.M	
USDPHP.N	
USDPHP.O	
USDPHP.Q	
USDPHP.S	
USDPHP.U	
USDPHP.V	
USDPHP.X	
USDPKR	US Dollar / Pakistani Rupee
USDPLN	USD / PLN
USDPLN.1	
USDPLN.2	
USDPLN.A	
USDPLN.B	
USDPLN.C	
USDPLN.D	
USDPLN.E	
USDPLN.G	
USDPLN.H	
USDPLN.J	
USDPLN.K	
USDPLN.M	
USDPLN.N	
USDPLN.O	
USDPLN.Q	
USDPLN.S	
USDPLN.U	
USDPLN.V	
USDPLN.X	
USDPYG	USD / PYG
USDQAR	US Dollar / Qatari Riyal
USDRON	USD / RON
USDRON.1	
USDRON.2	
USDRON.A	
USDRON.B	
USDRON.C	
USDRON.D	
USDRON.E	
USDRON.G	
USDRON.H	
USDRON.M	
USDRON.O	
USDRON.U	
USDRSD	USD / RSD
USDRUB	USD / RUB
USDRWF	US Dollar / Rwandan Franc
USDSAR	USD / SAR
USDSAR.1	
USDSAR.2	
USDSAR.3	
USDSAR.4	
USDSAR.5	
USDSAR.7	
USDSAR.A	
USDSAR.B	
USDSAR.C	
USDSAR.D	
USDSAR.E	
USDSAR.G	
USDSAR.H	
USDSAR.J	
USDSAR.K	
USDSAR.M	
USDSAR.O	
USDSAR.S	
USDSAR.U	
USDSAR.Y	
USDSCR	USD / SCR
USDSDG	US Dollar / Sudanese Pound
USDSEK	USD / SEK
USDSGD	USD / SGD
USDSOS	USD / SOS
USDSVC	USD / SVC
USDSZL	US Dollar / Swazi Lilangeni
USDTHB	USD / THB
USDTHB.A	
USDTHB.O	
USDTHB.S	
USDTJS	US Dollar / Tajikistani somoni
USDTMT	USD / TMT
USDTND	US Dollar / Tunisian Dinar
USDTRY	USD / TRY
USDTRY.1	
USDTRY.2	
USDTRY.3	
USDTRY.4	
USDTRY.5	
USDTRY.A	
USDTRY.B	
USDTRY.C	
USDTRY.E	
USDTRY.G	
USDTRY.H	
USDTRY.M	
USDTRY.O	
USDTRY.U	
USDTTD	US Dollar / Trinidad Dollar
USDTWD	USD / TWD
USDTWD.B	
USDTWD.C	
USDTWD.D	
USDTWD.E	
USDTWD.S	
USDTZS	US Dollar / Tanzanian Shilling
USDUAH	USD / UAH
USDUGX	US Dollar / Ugandan Shilling
USDUYU	USD / UYU
USDUZS	USD / UZS
USDVES	
USDVND	USD / VND
USDVND.1	
USDVND.2	
USDVND.B	
USDVND.C	
USDVND.D	
USDVND.E	
USDVND.G	
USDVND.H	
USDVND.J	
USDVND.K	
USDVND.M	
USDVND.N	
USDVND.Q	
USDVND.S	
USDVND.U	
USDVND.V	
USDVND.X	
USDXAF	US Dollar / Central African CFA franc
USDXCD	US Dollar / East Caribbean Dollar
USDXOF	US Dollar / West African CFA franc
USDXPF	US Dollar / French Pacific Franc
USDYER	US Dollar / Yemeni Rial
USDZAR	USD / ZAR
USDZAR.1	
USDZAR.2	
USDZAR.A	
USDZAR.B	
USDZAR.C	
USDZAR.D	
USDZAR.E	
USDZAR.G	
USDZAR.H	
USDZAR.J	
USDZAR.K	
USDZAR.M	
USDZAR.N	
USDZAR.O	
USDZAR.Q	
USDZAR.S	
USDZAR.U	
USDZAR.V	
USDZAR.X	
USDZMW	US Dollar / Zambia Kwacha
UYUEUR	UYU / EUR
UYUGBP	
UYUUSD	UYU / USD
UZSUSD	
VESEUR	
VESGBP	
VESUSD	
VNDCAD	
VNDEUR	
VNDGBP	
VNDJPY	VND / JPY
VNDUSD	Vietnamese Dong / US Dollar
VNDXAF	VND / XAF
XAFUSD	
XAGARS	XAG / ARS
XAGAUD	XAG / AUD
XAGBRL	XAG / BRL
XAGCAD	XAG / CAD
XAGCNY	XAG / CNY
XAGEUR	XAG / EUR
XAGGBP	XAG / GBP
XAGINR	XAG / INR
XAGJPY	XAG / JPY
XAGKRW	XAG / KRW
XAGMXN	XAG / MXN
XAGRUB	XAG / RUB
XAGSAR	XAG / SAR
XAGTRY	XAG / TRY
XAGUSD	XAG / USD
XAGZAR	XAG / ZAR
XAUARS	XAU / ARS
XAUAUD	XAU / AUD
XAUBRL	XAU / BRL
XAUCAD	XAU / CAD
XAUCNY	XAU / CNY
XAUEUR	XAU / EUR
XAUGBP	XAU / GBP
XAUINR	XAU / INR
XAUJPY	XAU / JPY
XAUMXN	XAU / MXN
XAURUB	XAU / RUB
XAUSAR	XAU / SAR
XAUUSD	XAU / USD
XAUZAR	XAU / ZAR
XOFUSD	
XPFGBP	XPF / GBP
XPFUSD	
YERGBP	
YERUSD	YER / USD
ZARAED	ZAR / AED
ZARARS	ZAR / ARS
ZARAUD	ZAR / AUD
ZARBRL	ZAR / BRL
ZARBWP	ZAR / BWP
ZARCAD	ZAR / CAD
ZARCHF	ZAR / CHF
ZARCNY	ZAR / CNY
ZARCOP	
ZARCZK	
ZARDKK	ZAR / DKK
ZAREGP	
ZAREUR	ZAR / EUR
ZARGBP	ZAR / GBP
ZARGHS	
ZARHKD	ZAR / HKD
ZARHUF	
ZARIDR	ZAR / IDR
ZARILS	
ZARINR	ZAR / INR
ZARJPY	ZAR / JPY
ZARKES	South African Rand / Kenyan Shilling
ZARKRW	ZAR / KRW
ZARLKR	
ZARLSL	
ZARMAD	
ZARMUR	ZAR / MUR
ZARMWK	
ZARMXN	ZAR / MXN
ZARMYR	ZAR / MYR
ZARNAD	South African Rand / Namibian Dollar
ZARNGN	
ZARNOK	ZAR / NOK
ZARNZD	ZAR / NZD
ZAROMR	ZAR / OMR
ZARPHP	ZAR / PHP
ZARPKR	ZAR / PKR
ZARPLN	ZAR / PLN
ZARRON	
ZARRUB	
ZARRWF	
ZARSEK	ZAR / SEK
ZARSGD	ZAR / SGD
ZARSZL	
ZARTHB	ZAR / THB
ZARTND	
ZARTRY	ZAR / TRY
ZARTWD	ZAR / TWD
ZARUGX	
ZARUSD	ZAR / USD
ZARUYU	
ZMWUSD	
ZMWZAR	ZMW / ZAR
